00100000110000011001
11111111100000000000
10000001100000000000
10000000100000000000
10001110111111100000
10001010100000100000
11111010000001100000
00001000011001000000
00001111111111000000